单位	单位 Å ℃ ％ ‰ ‱ ° ℉ ㏃ ㏆ ㎈ ㏄ ㏅ ㎝ ㎠ ㎤ ㏈ ㎗ ㎙ ㎓ ㎬ ㏉ ㏊ ㏋ ㎐ ㏌ ㎄ ㎅ ㎉ ㎏ ㎑ ㏍ ㎘ ㎞ ㏎ ㎢ ㎦ ㎪ ㏏ ㎸ ㎾ ㏀ ㏐ ㏓ ㎧ ㎨ ㎡ ㎥ ㎃ ㏔ ㎆ ㎎ ㎒ ㏕ ㎖ ㎜ ㎟ ㎣ ㏖ ㎫ ㎳ ㎷ ㎹ ㎽ ㎿ ㏁ ㎁ ㎋ ㎚ ㎱ ㎵ ㎻ ㏘ ㎩ ㎀ ㎊ ㏗ ㏙ ㏚ ㎰ ㎴ ㎺ ㎭ ㎮ ㎯ ㏛ ㏜ ㎔ ㏝ ㎂ ㎌ ㎍ ㎕ ㎛ ㎲ ㎶ ㎼
温度	温度 °
度	度 °
箭头	箭头 ⬆ ↗ ➡ ↘ ⬇ ↙ ⬅ ↖ ↕ ↔ ↩ ↪ ⤴ ⤵ 🔃 🔄 🔙 🔚 🔛 🔜 🔝 ↑ ⇑ ⇧ ⇡ ⇈ ↓ ⇓ ⇩ ⇣ ⇊ ← ⇐ ⇦ ⇠ ⇇ → ⇒ ⇨ ⇢ ⇉ ↵ ↳ ↰ ↱ ↶ ↷ ↺ ↻ ↚ ↛ ↮ ↜ ↝ ↞ ↟ ↠ ↡ ↢ ↣ ↤ ↥ ↦ ↧ ↨ ↫ ↬ ↭ ↯ ↲ ↴ ↸ ↹ ↼ ↽ ↾ ↿ ⇀ ⇁ ⇂ ⇃ ⇄ ⇅ ⇆ ⇇ ⇈ ⇉ ⇊ ⇋ ⇌ ⇍ ⇏ ⇔ ⇎ ⇕ ⇖ ⇗ ⇘ ⇙ ⇚ ⇛ ⇜ ⇝ ⇞ ⇟ ⇤ ⇥ ⇪ ⇫ ⇬ ⇭ ⇮ ⇯ ⇰ ⇱ ⇲ ⇳ ⇴ ⇵ ⇶ ⇷ ⇸ ⇹ ⇺ ⇻ ⇼ ⇽ ➔ ➘ ➙ ➚ ➛ ➜ ➝ ➞ ➟ ➠ ➢ ➣ ➤ ➥ ➦ ➧ ➨ ➩ ➪ ➫ ➬ ➭ ➮ ➱ ➲ ⎋ ➳ ➴ ➵ ➶ ➷ ➸ ➹ ➺ ➻ ➼ ➽ ➾ ⟰ ⟱
方向	方向 ↑ ↓ ← → ↕ ↔ ↖ ↗ ↙ ↘ ↚ ↛ ↮ ↜ ↝ ↞ ↟ ↠ ↡ ↢ ↣ ↤ ↥ ↦ ↧ ↨ ↩ ↪ ↫ ↬ ↭ ↯ ↰ ↱ ↲ ↳ ↴ ↵ ↶ ↷ ↸ ↹ ↺ ↻ ↼ ↽ ↾ ↿ ⇀ ⇁ ⇂ ⇃ ⇄ ⇅ ⇆ ⇇ ⇈ ⇉ ⇊ ⇋ ⇌ ⇐ ⇍ ⇑ ⇒ ⇏ ⇓ ⇔ ⇎ ⇕ ⇖ ⇗ ⇘ ⇙ ⇚ ⇛ ⇜ ⇝ ⇞ ⇟ ⇠ ⇡ ⇢ ⇣ ⇤ ⇥ ⇦ ⇧ ⇨ ⇩ ⇪ ⇫ ⇬ ⇭ ⇮ ⇯ ⇰ ⇱ ⇲ ⇳ ⇴ ⇵ ⇶ ⇷ ⇸ ⇹ ⇺ ⇻ ⇼ ⇽ ➔ ➘ ➙ ➚ ➛ ➜ ➝ ➞ ➟ ➠ ➡ ➢ ➣ ➤ ➥ ➦ ➧ ➨ ➩ ➪ ➫ ➬ ➭ ➮ ➱ ➲ ➳ ➴ ➵ ➶ ➷ ➸ ➹ ➺ ➻ ➼ ➽ ➾
上	上 ↑ ↟ ↥ ↾ ↿ ⇈ ⇑ ⇡ ⇧ ⇪ ⇫ ⇬ ⇭ ⇮ ⇯
下	下 ↓ ↡ ↧ ↯ ↴ ⇂ ⇃ ⇊ ⇓ ⇣ ⇩
左	左 ← ↚ ↜ ↞ ↢ ↤ ↩ ↫ ↰ ↲ ↵ ↶ ↸ ↺ ↼ ↽ ⇇ ⇐ ⇍ ⇚ ⇜ ⇠ ⇤ ⇦ ⇷ ⇺ ⇽
右	右 → ↛ ↝ ↠ ↣ ↦ ↪ ↬ ↱ ↳ ↷ ↻ ⇀ ⇁ ⇉ ⇒ ⇏ ⇛ ⇝ ⇢ ⇥ ⇨ ⇰ ⇴ ⇶ ⇸ ⇻ ➔ ➙ ➛ ➜ ➝ ➞ ➟ ➠ ➡ ➢ ➣ ➤ ➥ ➦ ➧ ➨ ➩ ➪ ➫ ➬ ➭ ➮ ➱ ➲ ➳ ➵ ➶ ➴ ➷ ➸ ➹ ➺ ➻ ➼ ➽ ➾
上下	上下 ↕ ↨ ⇅ ⇕ ⇞ ⇟ ⇳ ⇵ 
左右	左右 ↔ ↮ ↭ ↹ ⇄ ⇆ ⇋ ⇌ ⇔ ⇎ ⇹ ⇼
左上	左上 ↖ ⇖ ⇱
右上	右上 ↗ ⇗ ➚ ➶
左下	左下 ↙ ⇙
右下	右下 ↘ ⇘ ⇲ ➘ ➴ ➷ 
雷电	雷电 ↯
字母	字母 ⒜ ⒝ ⒞ ⒟ ⒠ ⒡ ⒢ ⒣ ⒤ ⒥ ⒦ ⒧ ⒨ ⒩ ⒪ ⒫ ⒬ ⒭ ⒮ ⒯ ⒰ ⒱ ⒲ ⒳ ⒴ ⒵ ⓐ ⓑ ⓒ ⓓ ⓔ ⓕ ⓖ ⓗ ⓘ ⓙ ⓚ ⓛ ⓜ ⓝ ⓞ ⓟ ⓠ ⓡ ⓢ ⓣ ⓤ ⓥ ⓦ ⓧ ⓨ ⓩ Ⓐ Ⓑ Ⓒ Ⓓ Ⓔ Ⓕ Ⓖ Ⓗ Ⓘ Ⓙ Ⓚ Ⓛ Ⓜ Ⓝ Ⓞ Ⓟ Ⓠ Ⓡ Ⓢ Ⓣ Ⓤ Ⓥ Ⓦ Ⓧ Ⓨ Ⓩ
数字	数字 一 二 三 四 五 六 七 八 九 〇 ㈠ ㈡ ㈢ ㈣ ㈤ ㈥ ㈦ ㈧ ㈨ ㈩ ❶ ❷ ❸ ❹ ❺ ❻ ❼ ❽ ❾ ❿ ⒈ ⒉ ⒊ ⒋ ⒌ ⒍ ⒎ ⒏ ⒐ ⒑ ⒒ ⒓ ⒔ ⒕ ⒖ ⒗ ⒘ ⒙ ⒚ ⒛ ⑴ ⑵ ⑶ ⑷ ⑸ ⑹ ⑺ ⑻ ⑼ ⑽ ⑾ ⑿ ⒀ ⒁ ⒂ ⒃ ⒄ ⒅ ⒆ ⒇ ① ② ③ ④ ⑤ ⑥ ⑦ ⑧ ⑨ ⑩ ⑪ ⑫ ⑬ ⑭ ⑮ ⑯ ⑰ ⑱ ⑲ ⑳ ㉑ ㉒ ㉓ ㉔ ㉕ ㉖ ㉗ ㉘ ㉙ ㉚ ㉛ ㉜ ㉝ ㉞ ㉟ ㊱ ㊲ ㊳ ㊴ ㊵ ㊶ ㊷ ㊸ ㊹ ㊺ ㊻ ㊼ ㊽ ㊾ ㊿ ❶ ❷ ❸ ❹ ❺ ❻ ❼ ❽ ❾ ❿ ⓫ ⓬ ⓭ ⓮ ⓯ ⓰ ⓱ ⓲ ⓳ ⓴ 壹 貳 叄 肆 伍 陸 柒 捌 玖 零 拾 佰 千 萬 億 兆
数学	数学 ⚮ ± ÷ × ∈ ∏ ∑ － ＋ ＜ ≮ ＝ ≠ ＞ ≯ ∕ √ ∝ ∞ ⟨ ⟩ ∟ ∠ ∥ ∧ ∨ ∩ ∪ ∫ ∮ ∴ ∵ ∷ ∽ ≈ ≌ ≒ ≡ ≤ ≥ ≦ ≧ ⊕ ⊙ ⊥ ⊿ ㏑ ㏒ 
雪花	雪花 ★ ☆ ⛤ ⛥ ⛦ ⛧ ✡ ❋ ❊ ❉ ❈ ❇ ❆ ❅ ❄ ❃ ❂ ❁ ❀ ✿ ✾ ✽ ✼ ✻ ✺ ✹ ✸ ✷ ✶ ✵ ✴ ✳ ✲ ✱ ✰ ✯ ✮ ✭ ✬ ✫ ✪ ✩ ✧ ✦ ✥ ✤ ✣ ✢
性别	性别 ♂ ♀ ⚢ ⚣ ⚤ ⚥ ⚦ ⚧ ⚨ ⚩
日期	日期 ㏠ ㏡ ㏢ ㏣ ㏤ ㏥ ㏦ ㏧ ㏨ ㏩ ㏪ ㏫ ㏬ ㏭ ㏮ ㏯ ㏰ ㏱ ㏲ ㏳ ㏴ ㏵ ㏶ ㏷ ㏸ ㏹ ㏺ ㏻ ㏼ ㏽ ㏾ ㋀ ㋁ ㋂ ㋃ ㋄ ㋅ ㋆ ㋇ ㋈ ㋉ ㋊ ㋋ ㍙ ㍚ ㍛ ㍜ ㍝ ㍞ ㍟ ㍠ ㍡ ㍢ ㍣ ㍤ ㍥ ㍦ ㍧ ㍨ ㍩ ㍪ ㍫ ㍬ ㍭ ㍮ ㍯ ㍰ ㍘ ㈪ ㈫ ㈬ ㈭ ㈮ ㈯ ㈰ ㈱ ㈲ ㈳ ㈴ ㈵ ㈶ ㈷ ㈸ ㈹ ㈺ ㈻ ㈼ ㈽ ㈾ ㈿ ㉀ ㉁ ㉂ ㉃
注音	注音 ㄅ ㄆ ㄇ ㄈ ㄉ ㄊ ㄋ ㄌ ㄍ ㄎ ㄏ ㄐ ㄑ ㄒ ㄓ ㄔ ㄕ ㄖ ㄗ ㄘ ㄙ ㄧ ㄨ ㄩ ㄚ ㄛ ㄜ ㄝ ㄞ ㄟ ㄠ ㄡ ㄢ ㄣ ㄤ ㄥ ㄦ
块	块 ▀ ▁ ▂ ▃ ▄ ▅ ▆ ▇ █ ▉ ▊ ▋ ▌ ▍ ▎ ▏ ▐ ░ ▒ ▓ ▔ ▕ ▖ ▗ ▘ ▙ ▚ ▛ ▜ ▝ ▞ ▟
八卦	八卦 ䷀ ䷁ ䷂ ䷃ ䷄ ䷅ ䷆ ䷇ ䷈ ䷉ ䷊ ䷋ ䷌ ䷍ ䷎ ䷏ ䷐ ䷑ ䷒ ䷓ ䷔ ䷕ ䷖ ䷗ ䷘ ䷙ ䷚ ䷛ ䷜ ䷝ ䷞ ䷟ ䷠ ䷡ ䷢ ䷣ ䷤ ䷥ ䷦ ䷧ ䷨ ䷩ ䷪ ䷫ ䷬ ䷭ ䷮ ䷯ ䷰ ䷱ ䷲ ䷳ ䷴ ䷵ ䷶ ䷷ ䷸ ䷹ ䷺ ䷻ ䷼ ䷽ ䷾ ䷿
卦	卦 ䷀ ䷁ ䷂ ䷃ ䷄ ䷅ ䷆ ䷇ ䷈ ䷉ ䷊ ䷋ ䷌ ䷍ ䷎ ䷏ ䷐ ䷑ ䷒ ䷓ ䷔ ䷕ ䷖ ䷗ ䷘ ䷙ ䷚ ䷛ ䷜ ䷝ ䷞ ䷟ ䷠ ䷡ ䷢ ䷣ ䷤ ䷥ ䷦ ䷧ ䷨ ䷩ ䷪ ䷫ ䷬ ䷭ ䷮ ䷯ ䷰ ䷱ ䷲ ䷳ ䷴ ䷵ ䷶ ䷷ ䷸ ䷹ ䷺ ䷻ ䷼ ䷽ ䷾ ䷿
扑克	扑克 ♠️ ♣️ ♥️ ♦️ 
标志	标志 ✢ ✣ ✤ ✥ ✦ ✧ ★ ☆ ✯ ✡︎ ✩ ✪ ✫ ✬ ✭ ✮ ✶ ✷ ✵ ✸ ✹ → ⇒ ⟹ ⇨ ⇾ ➾ ⇢ ☛ ☞ ➔ ➜ ➙ ➛ ➝ ➞ ♠︎ ♣︎ ♥︎ ♦︎ ♤ ♧ ♡ ♢ ♚ ♛ ♜ ♝ ♞ ♟ ♔ ♕ ♖ ♗ ♘ ♙ ⚀ ⚁ ⚂ ⚃ ⚄ ⚅ 🂠 ⚈ ⚉ ⚆ ⚇ 𓀀 𓀁 𓀂 𓀃 𓀄 𓀅 𓀆 𓀇 𓀈 𓀉 𓀊 𓀋 𓀌 𓀍 𓀎 𓀏 𓀐 𓀑 𓀒 𓀓 𓀔 𓀕 𓀖 𓀗 𓀘 𓀙 𓀚 𓀛 𓀜 𓀝
片假名	片假名 ア ァ イ ィ ウ ゥ エ ェ オ ォ カ ヵ ガ キ ギ ク グ ケ ヶ ゲ コ ゴ サ ザ シ ジ ス ズ セ ゼ ソ ゾ タ ダ チ ヂ ツ ッ ヅ テ デ ト ド ナ ニ ヌ ネ ノ ハ バ パ ヒ ビ ピ フ ブ プ ヘ ベ ペ ホ ボ ポ マ ミ ム メ モ ヤ ャ ユ ュ ヨ ョ ラ リ ル レ ロ ワ ヮ ヰ ヸ ヴ ヱ ヹ ヲ ヺ ン ・ ー ヽ ヾ ヿ ㇰ ㇱ ㇲ ㇳ ㇴ ㇵ ㇶ ㇷ ㇸ ㇹ ㇺ ㇻ ㇼ ㇽ ㇾ ㇿ
偏旁	偏旁 乛 冫 丷 龹 ⺌ 龸 亻 亼 亽 仒 冖 冂 冃 冄 宀 罒 㓁 罓 冈 凵 厶 刂 勹 匚 匸 卩 阝 厂 丆 广 壬 訁 讠 釒 钅 飠 饣 龺 攵 夂 夊 尢 尣 兂 旡 巜 巛 彐 彑 彡 彳 龰 辶 廴 㞢 忄 㣺 扌 爫 龵 廾 歺 癶 氵 氺 火 灬 爿 丬 疒 牜 ⺶ 犭 豕 豸 虍 艹 卝 龷 丗 龶 芈 丵 菐 黹 礻 衤 糸 糹 纟 龻 镸 髟 襾 覀 吅 㗊 㠭 㸚 叕
拼音	拼音 ā á ǎ à ō ó ǒ ò ê ê̄ ế ê̌ ề ē é ě è ī í ǐ ì ū ú ǔ ù ü ǖ ǘ ǚ ǜ ḿ m̀ ń ň ǹ ẑ ĉ ŝ ŋ Ā Á Ǎ À Ō Ó Ǒ Ò Ê Ê̄ Ế Ê̌ Ề Ē É Ě È Ī Í Ǐ Ì Ū Ú Ǔ Ù Ü Ǖ Ǘ Ǚ Ǜ Ḿ M̀ Ń Ň Ǹ Ẑ Ĉ Ŝ Ŋ
大写拼音	大写拼音 Ā Á Ǎ À Ō Ó Ǒ Ò Ê Ê̄ Ế Ê̌ Ề Ē É Ě È Ī Í Ǐ Ì Ū Ú Ǔ Ù Ü Ǖ Ǘ Ǚ Ǜ Ḿ M̀ Ń Ň Ǹ Ẑ Ĉ Ŝ Ŋ
声标	声标 ⁰ ¹ ² ³ ⁴ ⁵ ⁶ ⁷ ⁸ ⁹ ˜ ⁺ ⁻ ⁼ ⁽ ⁾ ᴬ ᵃ ᵄ ᵅ ᶛ ᴭ ᵆ ᴮ ᴯ ᵇ ᵝ ᶜ ᵓ ᶝ ᴰ ᵈ ᶞ ᵟ ᴱ ᵉ ᴲ ᵊ ᵋ ᶟ ᵌ ᶠ ᶡ ᶲ ᵠ ᴳ ᵍ ᶢ ˠ ᵞ ᴴ ʰ ᶣ ʱ ᴵ ⁱ ᶤ ᵎ ᶥ ᴶ ʲ ᶨ ᴷ ᵏ ᴸ ᶫ ˡ ᶩ ᶪ ᴹ ᵐ ᶬ ᵚ ᶭ ᴺ ᴻ ⁿ ᵑ ᶮ ᶯ ᴼ ᵒ ᶱ ᴽ ᴾ ᵖ ᴿ ʳ ʶ ʴ ʵ ˢ ᶴ ᶳ ᵀ ᵗ ᶵ ᶿ ᵁ ᵘ ᶶ ᶷ ᵙ ⱽ ᵛ ᶺ ᶹ ᵂ ʷ ˣ ᵡ ʸ ᶻ ᶾ ᶽ ᶼ
声调	声调 ˉ ˊ ˇ ˋ ˆ ˙ ˜ ˥ ˦ ˧ ˨ ˩ ꜀ ꜁ ꜂ ꜃ ꜄ ꜅ ꜆ ꜇
代号	代号 甲 乙 丙 丁 戊 己 庚 辛 壬 癸
制表符	制表符 ─ ━ │ ┃ ┄ ┅ ┆ ┇ ┈ ┉ ┊ ┋ ┌ ┍ ┎ ┏ ┐ ┑ ┒ ┓ └ ┕ ┖ ┗ ┘ ┙ ┚ ┛ ├ ┝ ┞ ┟ ┠ ┡ ┢ ┣ ┤ ┥ ┦ ┧ ┨ ┩ ┪ ┫ ┬ ┭ ┮ ┯ ┰ ┱ ┲ ┳ ┴ ┵ ┶ ┷ ┸ ┹ ┺ ┻ ┼ ┽ ┾ ┿ ╀ ╁ ╂ ╃ ╄ ╅ ╆ ╇ ╈ ╉ ╊ ╋ ╌ ╍ ╎ ╏ ═ ║ ╒ ╓ ╔ ╕ ╖ ╗ ╘ ╙ ╚ ╛ ╜ ╝ ╞ ╟ ╠ ╡ ╢ ╣ ╤ ╥ ╦ ╧ ╨ ╩ ╪ ╫ ╬ ╭ ╮ ╯ ╰ ╱ ╲ ╳ ╴ ╵ ╶ ╷ ╸ ╹ ╺ ╻ ╼ ╽ ╾ ╿